%%%%%%%%%%%%%%%%%%%%%%%
%.. .. ... .. .. .... %
% . ..   ..  . ... .. %
%  . . .. ...  . .. ..%
% .  ... .... .. .. ..%
%. . .. . .. . .  E ..%
% ..     . .  .  .. . %
% ..           .. .  .%
%..  . . .. . ... ..  %
%P ..       ... ... . %
%. . .. ... .....  ...%
% ... .. ...... ...   %
%%%%%%%%%%%%%%%%%%%%%%%