%%%%%%%%%%%%%%%%%%%%%%%%%%%%
%   P     .                %
%     .. .          .      %
%.      .                  %
%      ..                  %
%         .     .          %
%     .    .               %
%           .    .         %
% .       .  .             %
%         .   .            %
%              .           %
%                .         %
%         .        .       %
%                .   .     %
%                  .. .   E%
%      .                   %
%               .          %
%%%%%%%%%%%%%%%%%%%%%%%%%%%%