%%%%%%%%%%%%%%%%%%%%%%%%%%%%%%%%%%%%
%   .     . .   .    .  ...   .   P%
% %%%%%%%%%%%%%%%%%%%%%%% %%%%%%%% %
% %%.  %   %  .  .%%%%%%%. .%% .   %
% %% % % %.% %%%% %%%%%%%%% %%.%%%%%
% %%.% %.% %   .   .     %%.%% .  .%
%.%% % % % % %.%%%%  %%%    %%%%%% %
% % .% %.%   %.   %%.%%%%%%%% ..   %
%.%% % % %%%%%%%%.%%   .    %% %%%%%
% %% %  .%%  .  . %%%%%%%%%.%% .  .%
% .. %%%%%% %%%%%%% .    %% %%%%%% %
%%%%%%  ..  %  . .  %%%% %%.%   . E%
%   .  %%%%%% %%%%% %    %% %%.%%%%%
% %%%%%%  .   %    .. %%%%% %%  .  %
% .     .%%%%%% %%%%%%%%%%% %%. %% %
%%%%%%%%%%    . .   .       %%%%%% %
%.     . . %%%%%%%%%%%%%%%%   .  . %
%%%%%%%%%%%%%%%%%%%%%%%%%%%%%%%%%%%%