%%%%%%%%%%%%%%%%%%%%
%.    . .       P .%
%E   .  .        . %
%  .        .    ..%
%%%%%%%%%%%%%%%%%%%%
