%%%%%%%%%%%%%%%%%%%%
%.    . .    .  P .%
%E   .  .        . %
%  .        .    ..%
%%%%%%%%%%%%%%%%%%%%
