%%%%%%%%%%%%%%%%%%%%
%.    . .       P .%
%E  .   .    .    .%
%         .  .    .%
%%%%%%%%%%%%%%%%%%%%
