%%%%%%%%%%%%%%%%%%%%%%%%%%%%%%%%%
%   .          .        .  .    %
%    .                .       . %
%.                             E%
%                          .    %
%  .                            %
%         .                     %
%             .            .    %
%  .                         .  %
%       .                       %
% .                             %
%     .   .                  .  %
%                               %
%     .                         %
%  .                        .   %
%                               %
%   .     P                 .   %
%       .                       %
%%%%%%%%%%%%%%%%%%%%%%%%%%%%%%%%%