%%%%%%%%%%%%%%%%%%%%%%%%%%%%
%   P     .                %
%                   .      %
%.                         %
%     .          .         %
% .                        %
%          .               %
%                          %
%   .     .                %
%                          %
%   .                     E%
% .    .                   %
%         .     .   ..     %
%     .                    %
%              .     .     %
%.     ..        .         %
%%%%%%%%%%%%%%%%%%%%%%%%%%%%