%%%%%%%%%%%%%%%%%%%%%%%%%%%
%    .         P          %
%          .         .    %
%        .        .       %
%E                .       %
%  .   .   .              %
%%%%%%%%%%%%%%%%%%%%%%%%%%%
