%%%%%%%%%%%%%%%%%%%%%%%%%%%%%%%%%
%   .  P       .                %
%    .                .       . %
%.                              %
%                          .    %
%  .                            %
%.    .                         %
%                               %
%  .                            %
%       .                      E%
% .                             %
%     .                  .   .  %
%                       .       %
%     .     .         .         %
%  .            .           .   %
%                    .          %
%   .         .             .   %
%       .                       %
%%%%%%%%%%%%%%%%%%%%%%%%%%%%%%%%%