%%%%%%%%%%%%%%%%%%%%
%         .. P     %
%E   ..       .  . %
%         .   .    %
%%%%%%%%%%%%%%%%%%%%